World: Java Kara Level 8
X: 9
Y: 9
#########
#####   #
#  @  # #
# ##### #
#  #### #
##  .## #
#### ## #
####    #
#########